1111111111111
1CE10CCC000E1
1000011101001
10P011CC000K1
1111111111111