11111111111111111111
1E0C001K0000000000E1
110010100011C1100001
1101101000110C100001
110C1011000111110001
1C001000000100K00001
1C111011110100C00001
1C00C010111100C00001
1100C010CC0100P00001
11011010100101011101
1CCCCC00100001CCCC01
11111111111111111111
